zone1
11 11
###########
#.........#
#...C.....#
#......C..#
#.C.......#
#..........
#.........#
#...C.....#
#......C..#
#.........#
#####.#####
5 0 0 5 10
5 10 2 5 0

zone2
11 11
#####.#####
#.........#
#.C.......#
#.........#
#.........#
...........
#.........#
#......C..#
#.........#
#.........#
#####.#####
5 0 1 5 10
5 10 3 5 0
10 5 5 0 5

zone3
11 11
###########
#.........#
#.C....C..#
#.........#
#......C..#
..........#
#.........#
#..C......#
#.........#
#......C..#
#####.#####
5 0 2 5 10
10 5 6 0 5

zone4
11 11
#####.#####
#..C......#
#.........#
#.........#
#.........#
#..........
#....C....#
#.........#
#.C....C..#
#.........#
#####.#####
0 5 1 10 5
5 10 5 5 0
10 5 7 0 5

zone5
11 11
#####.#####
#.........#
#.........#
#..C......#
#.........#
...........
#.........#
#.........#
#......C..#
#.........#
#####.#####
0 5 2 10 5
5 0 4 5 10
5 10 6 5 0
10 5 8 0 5

zone6
11 11
#####.#####
#.........#
#..C......#
#.........#
#......C..#
..........#
#.........#
#.C.......#
#.........#
#.......C.#
#####.#####
0 5 3 10 5
5 0 5 5 10
10 5 9 0 5

zone7
11 11
#####.#####
#......C..#
#.........#
#.C.......#
#.........#
#..........
#.........#
#.C.......#
#.....C...#
#.........#
###########
0 5 4 10 5
5 10 8 5 0

zone8
11 11
#####.#####
#.........#
#.C.......#
#.........#
#.........#
...........
#....C....#
#.........#
#.........#
#.........#
###########
0 5 5 10 5
5 0 7 5 10
5 10 9 5 0

zone9
11 11
#####.#####
#.C.......#
#.........#
#....C....#
#.........#
..........#
#.........#
#.........#
#.C....C..#
#.........#
###########
0 5 6 10 5
5 0 8 5 10